##############################
#       #         #          #
#       #         #          #
#       #         #          #
# ####  #         #          #
#                 # ######   #
#                        #   #
#                        #   #
# ############ ##        #   #
#     #         #        #   #
#               #        #   #
#     ###########        # # #
#     #                  #   #
#     #                      #
##############################